######################################################
#@#                           #        #       #     F
# # # ######## ####### ### ##### #####    #### # #####
# # # # #      #       # # #    # #   #####  # #     #
#   #   #  ########### #     # #   #    #### # ### # #
# #######  # #   #   ######### # ###### #    #   # ###
# #   #    #   # # #   #     # # #   #  # # ## # #   #
# # # ########## # ##### ### # # # # ## # # ## ###   #
# # # #   #    # #         # #   # # #    # # ####   #
#   #   #    # # ######### # ##### ######## # #    # #
# # ##########   #       # #     #   #      # #  #####
# #          # ####### #   # ####### ########### #   #
# #########  # #     # ##### #   # # #   #   # # ### #
# #   #   ########## #     #   # # #   # # #   #   # #
#   # # #          # ##### # ### # # # # # ###### ## #
##### # # ######## # #   # # # #   # ###   # # #     #
#     # # #      #   # # # # # #####   # #   #   # # #
# ##### # ###### ##### # # ### #   ### # ########### #
#       #              #         #     #             #
######################################################

