+--+--+--+--+--+--+--+--+--+--+--+--+--+--+--+
| @             |     |           |  |        |
+  +--+  +  +--+  +  +--+--+--+  +  +  +--+  +
|     |  |     |  |  |     |     |        |  |
+--+  +--+--+  +  +  +  +  +  +--+--+  +  +--+
|  |  |     |     |     |  |        |  |     |
+  +  +  +  +--+--+--+  +  +--+  +  +--+--+  +
|     |  |              |        |        |  |
+--+--+  +--+--+  +--+--+--+--+--+  +--+--+  +
|  |     |        |        |     |        |  |
+  +  +--+  +--+--+  +  +--+  +  +--+--+  +  +
|     |        |     |  |     |  |           |
+--+--+  +--+--+  +  +--+  +--+  +  +--+  +  +
|     |        |  |        |  |     |  |  |  |
+  +  +--+--+  +  +--+--+--+  +--+--+  +  +  +
|  |  |  |     |           |  |     |  |  |  |
+--+  +  +  +--+--+--+--+  +  +  +  +  +  +  +
|     |     |        |     |     |  |     |  |
+  +--+--+--+  +  +--+  +--+--+--+  +--+  +  +
|              |  |     |     |  |     |  |  |
+  +--+--+  +--+--+  +--+  +  +  +--+  +--+  +
|  |     |           |     |     |           |
+  +  +  +--+--+--+  +  +--+--+--+  +  +--+--+
|  |  |           |  |  |           |  |     |
+  +  +--+  +--+  +  +  +  +--+--+--+  +  +--+
|  |  |  |     |  |  |     |           |     |
+  +  +  +--+  +  +  +--+--+  +--+--+--+--+  +
|  |  |        |  |     |  |  |        |     |
+  +  +--+--+--+  +--+  +  +  +  +--+  +  +  +
|     |              |     |     |        |  F 
+--+--+--+--+--+--+--+--+--+--+--+--+--+--+--+