#####################
# #@        #       #
# ######### # ### # #
#   #     # # # # # #
# # # ### # # # # # #
# # # # # # # # # # #
# # # # # # # # # # #
# # # # # # #   # # #
# # # # # # ### # # #
# # # #   # #   # # #
# # # ##### ##### # #
# #   #   # #   # # F
# ##### # # # # # ###
#       # # # # #   #
# ####### # # # ### #
# # #     #   # #   #
# # # ######### # ###
# # #           #   #
# # ############### #
#                   #
#####################