+--+--+--+--+--+--+--+--+--+--+--+--+--+--+--+--+--+--+--+--+--+--+--+--+--+--+--+--+--+--+
| @       |           |     |                 |           |     |                 |        |
+--+--+  +  +--+--+  +  +  +  +--+--+--+--+  +--+--+  +  +  +  +--+  +--+  +--+--+  +  +  +
|        |  |        |  |  |  |     |  |     |        |     |  |     |  |  |     |  |  |  |
+  +--+--+  +  +--+--+--+  +  +--+  +  +  +--+  +--+--+--+--+  +  +--+  +  +  +  +  +--+  +
|     |     |  |        |  |     |  |     |     |     |     |     |     |     |  |  |     |
+--+  +  +--+  +  +--+  +  +--+  +  +  +--+  +  +  +  +--+  +--+--+  +--+--+--+  +--+  +--+
|     |  |     |  |  |  |        |  |  |     |     |  |     |     |           |           |
+  +--+  +  +--+  +  +  +--+--+--+  +  +  +--+--+  +  +  +--+--+  +--+  +--+  +--+--+  +  +
|  |     |     |  |  |  |     |     |  |  |        |  |  |     |     |     |           |  |
+  +  +--+  +  +  +  +  +  +  +--+  +  +  +  +--+--+  +  +  +  +--+  +--+--+--+--+--+--+  +
|     |     |     |     |  |  |     |     |     |        |  |              |        |     |
+--+--+  +--+--+--+--+--+  +  +  +  +  +--+--+  +  +  +--+  +--+--+--+--+  +  +  +--+  +  +
|     |        |  |     |  |     |  |  |     |  |  |  |     |  |           |  |        |  |
+  +--+--+--+  +  +  +  +  +  +--+  +  +  +  +--+  +  +  +--+  +  +--+--+--+  +--+--+--+--+
|  |              |  |     |  |  |     |  |     |  |  |        |     |        |           |
+  +  +--+--+--+--+  +--+--+  +  +--+--+--+--+  +  +  +--+--+--+--+  +  +--+--+--+--+--+  +
|           |     |  |     |        |     |  |  |  |  |        |     |              |  |  |
+--+  +--+  +  +  +  +  +--+  +  +  +--+  +  +  +  +  +  +--+  +--+  +--+--+--+--+  +  +  +
|     |        |     |        |  |        |        |     |                       |        F
+--+--+--+--+--+--+--+--+--+--+--+--+--+--+--+--+--+--+--+--+--+--+--+--+--+--+--+--+--+--+