#######@#################################
#       #               #         #     #
# ####### ######### # # # ####### # ### #
#         #       # # # #       # #   # #
# ####### # # ##### # ########### # ### #
# #       # #   #   # #           # #   #
# ####### # # ##### # ########### # # # #
#         # #     # #     #       # # # #
########### # ### # # ### ######### # # #
#           #   # # #   # #         # # #
# ############### # ##### # ######### ###
# #       #     # # #     # #       #   #
# ### # # # # # # # # ### # # ######### #
#   # # # # # # # # # # # #   #         #
# # # # # # # # # # # # # ### # #########
# # # # # # # #   # # # # # # #         F
### # # # # # #   # # # # # # ###########
#   # # #     #     # # # # # #         #
# ##### #######     # # # # # # ####### #
# #     #             #   # # # #     # #
# # ##### ############### # # # # ### ###
# #     #               # # # # # # #   #
# # ####### ########### # # # # # # ### #
# # #     # #         # #   # # #   #   #
# # ##### ##### ####### # ### # ### ### #
# # #     #   # #     # # # # # #   # # #
# # ##### ##### ####### # ### # ### # # #
# # #     #   # #     # # # # # #   # # #
# # # ### # # # # ### # # # # ### ### # #
# # #   #   # # # # # # # # # #   #   # #
# # ### ####### # # # # # # # # ##### # #
# #     #     # # # # # # # # #     # # #
# ####### ### # # # # # # # # ##### # # #
# #       # #     # # # #   #       # # #
# # ####### ####### # # ############# # #
# # #     # #   #     # #         #   # #
# # # # # # # # ####### # ##### # # # # #
# # # # # # # #         # #   # #   # # #
# # ### # # # ########### # # # ####### #
#       #   #               # #         #
#########################################