###############################################################################
#@#       #       #         #           #     #                 #     #       F
# ### ### ##### # ### ##### ### ##### ### ### # # ############# ### # ##### # #
#     # #     # #     #   #   # #   #     # #   # #           #   # #       # #
####### ##### # ####### # ### # # ##### ### ##### # ######### ### # ### #######
#           #   #       #   # # # #   #         #         #   #   # #   #     #
# # # ############### ##### # # # # # ######### ########### ##### # # ### ### #
# # # #           #   #     # # # # #     #     # #         #   #   # #     # #
# # ### ####### # # ### ##### # # # ##### # ##### # ####### # # ### ### ##### #
# # #       #   #   #   #     #   # #   # #       # #   #   # #   # #   #     #
### # ####### ##### ##### ######### # # # ####### # # # # ### ### ### ### ### #
#   # #       #   # #   # #         # # #       # #   # #   # #   #   # # #   #
# # # # # ##### ### # # # # # ######### ####### ##### # ##### # ### ### # ### #
# # # # # #   # #     #   # # #       #   #   # #   # #       #         #   # #
# ### # # # # # ############# # ##### # # # ### # # ##### ########### ##### # #
#     # # # #   #   #         #   #     # #   #   #     # #     #   # #     # #
# ##### # # ##### # # # ####### # ####### ### ######### # # ##### # # # #######
# #   #   # #     # # # #   #   # #   #             #   #   #     # # #       #
# ### ### # ##### # ### # # # ### # # ########### ### ####### ##### ######### #
#   #   #   #   # #   #   # # # #   #     #       #   #   #   #   #         # #
### ### ##### # # ### ##### # # ######### ######### ### # # ### ##### # ### # #
#             #   #         #           #               #   #           #     #
###############################################################################