+--+--+--+--+--+--+--+--+--+--+
| @|     |        |           |
+  +--+  +  +  +--+  +--+--+  +
|  |     |  |        |        |
+  +  +--+--+--+--+--+  +--+--+
|     |     |     |        |  |
+--+  +  +  +  +  +  +--+  +  +
|     |  |     |  |     |  |  |
+  +--+--+--+  +--+--+  +  +  +
|        |     |     |  |  |  |
+  +--+  +  +--+  +  +--+  +  +
|  |  |  |     |  |  |     |  |
+  +  +  +--+  +  +  +  +--+  +
|     |        |  |     |     |
+  +--+--+--+--+  +  +--+  +--+
|  |           |  |  |        |
+  +  +--+--+  +  +  +  +--+  +
|  |  |        |  |  |     |  |
+  +  +  +--+--+  +  +--+  +  +
|     |           |        | F| 
+--+--+--+--+--+--+--+--+--+--+