+--+--+--+--+--+--+--+--+--+--+--+--+--+--+--+--+--+--+--+--+
|@ |     |  |     |     |        |     |     |     |        |
+  +--+  +  +  +  +--+  +  +--+  +  +  +--+  +  +  +  +--+  +
|  |     |     |  |     |     |  |  |  |        |     |     |
+  +  +  +  +--+  +  +--+--+  +  +  +  +  +  +--+--+--+  +--+
|  |  |  |  |  |        |     |  |  |  |  |           |  |  |
+  +  +  +  +  +--+  +  +--+--+  +  +  +  +--+--+  +--+  +  +
|     |     |     |  |        |     |  |        |  |     |  |
+--+  +--+--+--+  +  +--+--+  +  +--+  +  +--+  +  +  +--+  +
|              |     |           |        |     |  |       F|
+--+--+--+--+--+--+--+--+--+--+--+--+--+--+--+--+--+--+--+--+