+--+--+--+--+--+--+--+--+--+--+--+--+--+--+--+--+--+--+--+--+
|@ |     |              |     |        |        |           |
+  +  +  +--+  +--+--+  +  +  +  +  +  +--+--+  +  +--+--+  +
|     |        |        |  |  |  |  |  |        |     |     |
+--+--+  +--+--+  +--+  +  +  +--+  +  +  +  +--+--+  +  +--+
|     |  |     |  |     |  |        |  |  |  |     |  |     |
+  +--+  +  +  +  +  +--+  +--+--+--+  +  +  +  +  +  +--+  +
|           |  |  |     |     |     |  |  |     |     |     |
+--+--+  +--+  +  +--+--+--+  +  +--+  +  +  +--+--+--+  +--+
|        |     |        |     |     |     |  |  |        |  |
+  +--+--+  +--+--+--+  +--+  +--+  +--+--+  +  +  +  +  +  +
|        |           |        |     |     |  |     |  |     |
+  +  +--+--+--+--+  +--+--+--+--+  +  +--+  +--+--+  +--+--+
|  |     |        |  |     |        |        |  |     |     |
+--+--+  +  +--+  +  +--+  +  +--+--+--+--+--+  +  +  +  +  +
|        |  |  |              |           |        |  |  |  |
+  +--+--+  +  +--+  +--+--+--+  +--+--+  +  +--+--+  +  +  +
|        |  |  |     |     |     |        |        |  |  |  |
+--+--+  +  +  +  +--+  +  +  +--+  +--+--+--+  +  +--+  +  +
|        |     |        |     |     |           |        |F |
+--+--+--+--+--+--+--+--+--+--+--+--+--+--+--+--+--+--+--+--+