+--+--+--+--+--+--+--+--+--+--+--+--+--+--+--+--+--+--+--+--+
| @         |           |           |        |        |     |
+--+--+--+  +  +--+--+  +--+--+--+  +  +--+  +  +--+  +  +--+
|        |     |              |     |     |     |     |     |
+--+  +  +--+--+  +--+  +--+  +  +--+--+  +--+--+  +--+--+  +
|     |     |     |  |  |     |           |  |     |     |  |
+  +--+--+--+  +--+  +  +  +  +--+  +--+--+  +  +--+  +  +  +
|              |  |     |  |        |        |        |     |
+--+--+  +--+--+  +--+--+  +--+--+--+  +--+--+--+  +--+--+  +
|     |     |     |     |        |     |     |     |        |
+--+  +--+  +  +--+  +  +--+--+  +  +--+--+  +  +--+  +  +--+
|     |     |        |     |     |           |  |     |  |  |
+  +--+  +--+--+  +--+--+--+  +--+--+  +--+--+  +--+--+  +  +
|     |  |     |           |     |  |        |     |     |  |
+--+  +  +--+  +--+--+--+  +--+  +  +--+--+  +  +  +  +--+  +
|     |  |              |     |  |     |     |  |  |        |
+  +--+  +  +  +--+--+--+--+  +  +--+  +  +--+--+  +--+--+--+
|           |              |  |     |  |  |           |    F|
+--+--+  +--+--+--+  +--+  +  +--+  +  +  +  +--+  +  +--+  +
|        |           |        |        |     |     |        |
+--+--+--+--+--+--+--+--+--+--+--+--+--+--+--+--+--+--+--+--+
