+--+--+--+--+--+--+--+--+--+--+--+--+--+--+--+--+--+--+--+--+
| @|        |        |     |              |     |           |
+  +  +--+  +--+  +  +  +  +--+--+--+  +  +  +  +  +--+--+  +
|  |     |     |  |  |  |  |        |  |  |  |  |     |     |
+  +--+  +--+  +  +--+  +  +  +--+  +--+  +  +--+--+  +  +--+
|        |        |     |     |  |        |     |     |     |
+  +--+--+--+--+  +  +--+--+--+  +--+--+--+  +  +  +--+--+  +
|  |     |        |  |        |        |     |  |     |     |
+  +  +--+  +  +--+  +  +--+  +  +--+--+  +--+  +--+  +  +--+
|  |        |     |  |     |        |     |  |        |     |
+  +--+  +--+--+--+  +--+--+--+  +  +  +--+  +--+--+--+  +  +
|  |     |        |     |     |  |     |        |        |  |
+  +--+--+--+  +  +--+  +  +  +  +  +--+  +  +--+  +--+--+  +
|        |     |  |  |  |  |     |     |  |     |  |     |  |
+--+--+  +  +--+  +  +  +  +--+--+--+  +  +--+  +  +  +  +--+
|     |     |     |     |  |        |  |     |  |     |     |
+  +--+--+--+  +--+--+  +  +--+--+  +  +--+  +  +--+--+--+  +
|           |  |     |  |     |  |     |     |           |  |
+  +--+--+  +  +  +  +  +--+  +  +--+  +  +--+--+--+--+  +  +
|        |        |           |        |             F|     | 
+--+--+--+--+--+--+--+--+--+--+--+--+--+--+--+--+--+--+--+--+